30 17 100
1	1	1	1	1	1	1	1	1	1	1	1	1	1	1	1	1	1	1	1	1	1	1	1	1	1	1	1	1	1
1	0	0	0	0	0	0	0	0	1	0	0	0	0	0	0	0	1	0	0	0	0	0	0	0	1	0	0	0	2
1	0	0	0	0	0	0	0	0	1	0	0	0	0	0	0	0	1	0	0	0	0	0	0	0	1	0	0	0	1
1	0	0	0	0	0	0	0	0	1	0	0	0	0	0	0	0	1	0	0	0	0	0	0	0	1	0	0	0	3
1	0	0	0	0	0	0	0	0	1	0	0	0	1	0	0	0	4	0	0	0	1	0	0	0	1	0	0	0	1
1	0	0	0	1	1	0	0	0	1	0	0	0	1	0	0	0	1	0	0	0	1	0	0	0	5	0	0	0	4
1	0	0	0	1	1	0	0	0	1	0	0	0	2	0	0	0	1	0	0	0	3	0	0	0	1	0	0	0	1
1	0	0	0	1	5	0	0	0	5	0	0	0	1	0	0	0	4	0	0	0	1	0	0	0	1	0	0	0	5
1	0	0	0	1	1	0	0	0	1	0	0	0	1	0	0	0	1	0	0	0	1	0	0	0	5	0	0	0	1
1	0	0	0	1	1	0	0	0	1	0	0	0	5	0	0	0	1	0	0	0	2	0	0	0	1	0	0	0	2
1	0	0	0	1	1	0	0	0	1	0	0	0	1	0	0	0	3	0	0	0	1	0	0	0	1	0	0	0	1
1	0	0	0	1	1	0	0	0	1	0	0	0	1	0	0	0	1	0	0	0	1	0	0	0	5	0	0	0	3
1	0	0	0	5	1	0	0	0	1	0	0	0	1	0	0	0	1	0	0	0	2	0	0	0	1	0	0	0	1
1	0	0	0	1	1	0	0	0	0	0	0	0	1	0	0	0	0	0	0	0	1	0	0	0	0	0	0	0	4
1	0	0	0	1	1	0	0	0	0	0	0	0	4	0	0	0	0	0	0	0	1	0	0	0	0	0	0	0	1
1	0	0	0	1	1	0	0	0	0	0	0	0	1	0	0	0	0	0	0	0	1	0	0	0	0	0	0	0	5
1	1	1	1	1	1	1	1	1	1	1	1	1	1	1	1	1	1	1	1	1	1	1	1	1	1	1	1	1	1
Target 1 15 3 1 20
NormalSpawner 26 1 3 3 45 90 20
SmallerSpawner 26 1 3 3 30 300 30
TankerSpawner 26 1 3 3 60 600 30
BossSpawner 26 1 3 3 90 900 10


